919999999999999999999999999999999999999999999999999999999999999999999999999999999999999999999999999
919111111111911191119111111111911111911111911111111191119111111111911111111111111111111111911111119
919991999991919191919991919991919991919991919199999191919199999991919999999999999999919991999991919
911191119111119191911191911191119111919191919111911191919191111191119111911191119111919191119111919
999199919999999191999199999199999991919191919991919991999191999199999191919191919191919199919199919
919111911111919191919111119111111191119111911191911191111191911191111191919191911191119111911191119
919991999191919191919999919199999199999199999191999191999999919991999991919191999999999191999991999
911191119191919111911191119191119191119191111191911191111191119111919111919191911111119191911191119
919199919191919999919991999191919191999199999991919999999191999199919199919191919999919191999199919
919111919191911111119111911191919191119111111191911111911191911191119111119191119111919191111111919
919191919191919999919199919991919199919999999191999991919991919991919999999199919199919199999199919
919191919191919111119191919111919111911111119191911191911111911191911111119111911191119111119191119
919199919991999199919191919199999991999991999191919191919999919199999991999991999991999199919991999
919111911191911191119191119111911191111191111111919191919111919191111191111191911111919191911111919
919991999191919999999191999991919199999199999999919191999191919191999191999191919999919191999999919
919191111191911111111191111111919111119111111111919191111191919191911191919111919111111191111111119
919199999991919999999999999991919999919999999991919999999991919191919991919999919199999999919999919
911191111111919111111111911111911111911111111191911111119191919111919191111191119191911111919191119
999191999999919191999991999999999991999999999191919199919191919999919199999199919191919191919191999
911191911111119191119191111191111191119111911191919111919191911191119111119111919191119191919191119
919991919999999999919199999191999191919991919991919991919191999191999199919991919199999191919199919
919111911191111111919111119111919191911191911191911191919191119191119191919191919111911191119111919
919199999191919991919191919999919199999191999191999191919199919999919191919191919991919999999199919
911191911191919191119191919191111191119191111191911191911191911111119191119191119111911191911111119
999991919991919199999991919191999991919191999991999991999191999999999191999199999199999191919999999
911191119111919111111191919191111111911191111191111191911191111111911191119111119111111191919111119
919991999991919999919191919199999999999999999191999191999191999991919999919999919999999991919991919
911111911191919111919191911111119111111191119191119191119111911191911191111111119111111111119111919
919999919199919191919191919999999191999191919199999191919999919191919199999991999199999999999199919
911191119111119191919111919111111191911191919111119191919111119111919111119111911191111191111191119
999191919999999191919999999199999991919991919999919191919999999991999999919199919991999191919991999
911191919191111191119111119111111191911111919111119191911111111191111111919191911191119111919191119
919999919191919999999199919999999191919999999199999199999199999199999991919191999199919999919199919
919111119111911111111191119111111191919111111191111111119111119191111111919191119111911191119111119
919199999991999999999991999199999991919199999991999999919999999199999991919199919991919991999199999
919111111191911111911191111191111191919191111191119111911111119111111191119111911191919111919111919
919999999191919191999199999999919991919199919991999191919999919199999199999991919191999199919991919
911191119191919191111191111111911191919111911111911191919191119111119111119191119191119111911191119
999191919191999199999199999191999191919991999199919991919191999999919999919199919999919991919999919
919191919191119191119111119191119191911191119111919191911191911111919191119111119111911191919111119
919191919199919191999999919199919191999999919991919191999191919991919191919999999191999191919199999
911191919111911191111111119191911191111191119111919191119191911191919191919111111191111191919111919
919991919991999991999999999191999199999191999999919199919191999191919191999199999999999991919991919
911111911191911191119111111191911191911191111111119191119191911191111191111111111191111111911191119
999999999191919199919999919991919991919199999999999191999991919999999999999999999199919999919199919
911111119191919111911111911191119111919191111111119191111191919111111111119111119111911111919111919
919999919191919991999991999191999191919199999991919199999191999199999999919199999991999991919199919
911191119111919191119191119191119191919111911191919111919191111191119191119111111191111191919191119
919991999999919199919199919199919191919991919191919191919191999991919191999199919999999191919191999
919111911111119111111111911191119191919111919191919191919191111111911191119191911111119191919111919
919199919199999991999999999991999191919199919191919191919199999199999991919191999199999191919999919
919191119111111191119111911191111191919111119111911191119111911191111191919191119111111191911111919
919191999999999191999191919199999199919199999999919999999991999191999199919191919999999991999991919
919191911111119191911191119191111191119191111111919111111191119191919111919191919111911191111191119
919191919999919199919999999191999991999991999991999199999199919991919991919191919191919199999199919
919111119111119111111111119111111191111111111191111111119111111111911111119111911191119111111191119
999999999999999999999999999999999999999999999999999999999999999999999999999999999999999999999999919